XXXXXXXXXXXXXXXXXXXX
X******41686XXXX63bX
X8XXXXX*XXX86291X59X
X6X745*17248XXX9X72X
X836X*XX7XX6XXX4319X
XXXXX*XX7665XX77XX9X
X665X*563XXXX13XX28X
X4X62*XXXXXXXX12233X
X6XXX1*213cXXX2XXX7X
XX63183***27X718259X
X14464XXXX*3X5XXX64X
X6562753XX6*X6XXX77X
XXXXX635X68*X9XXX1XX
Xe77X978XX*78558976X
X327X5327*43XXXXXf8X
XX3XX476*6833821X67X
XXXXXXX*XXXX2XX4952X
X2893**743XX4XX7X5XX
X164527951272XX254XX
XXXXXXXXXXXXXXXXXXXX
