XXXXXXXXXXXXXXXXXXXX
Xa1184441686XXXX63bX
X8XXXXX2XXX86291X59X
X6X745117248XXX9X72X
X836X1XX7XX6XXX4319X
XXXXX2XX7665XX77XX9X
X665X4563XXXX13XX28X
X4X621XXXXXXXX12233X
X6XXX11213cXXX2XXX7X
XX6318312427X718259X
X14464XXXX13X5XXX64X
X6562753XX61X6XXX77X
XXXXX635X682X9XXX1XX
Xe77X978XX278558976X
X327X5327543XXXXXf8X
XX3XX47646833821X67X
XXXXXXX6XXXX2XX4952X
X2893d9743XX4XX7X5XX
X164527951272XX254XX
XXXXXXXXXXXXXXXXXXXX